1|0,1|0,1|0,1|0,1|0,1|0,1|0,1|0,1|0,1|0,1|0,1|0,1|0,1|0,1|0,1|0,1|0,1|0,1|0,1|0,1|0,1|0,1|0,1|0,1|0
1|0,0|0,0|0,0|0,0|0,0|0,0|0,0|0,0|0,0|0,0|0,0|0,0|0,0|0,0|0,0|0,0|0,0|0,0|0,0|0,0|0,0|0,0|0,0|0,1|0
1|0,0|1,0|1,0|0,0|0,P|0,0|0,0|0,0|0,0|0,0|0,0|0,0|0,0|0,0|0,0|0,0|0,0|0,0|0,0|0,0|0,0|0,0|0,0|0,1|0
1|0,0|1,0|1,0|0,0|0,0|0,0|0,0|0,0|0,0|0,0|0,1|0,L|0,1|0,1|0,1|0,0|0,0|0,1|0,0|1,0|1,0|1,0|1,0|1,1|0
1|0,1|1,1|1,0|0,0|0,1|0,1|0,1|0,1|0,0|0,0|0,0|0,L|0,0|0,0|0,0|0,0|0,0|0,1|0,0|1,0|1,0|1,0|1,0|1,1|0
1|0,0|0,0|0,0|0,0|0,0|0,0|0,0|0,1|0,0|0,0|0,0|0,L|0,0|0,0|0,0|0,0|0,0|0,1|0,1|0,1|0,1|1,0|1,0|1,1|0
1|0,1|0,1|0,1|0,1|0,1|0,1|0,1|0,1|0,1|0,1|0,1|0,1|0,1|0,1|0,1|0,1|0,1|0,1|0,1|0,1|0,1|0,1|0,1|0,1|0