1,1,1,1,1,1,1,1,1,1,1,1,1,1,1,1,1,1,1,1,1,1,1,1,1
1,0,0,0,0,0,0,0,0,0,0,0,0,0,0,0,0,0,0,0,0,0,0,0,1
1,0|1,0|1,0,0,P,0,0,0,0,0,0,0,0,0,0,0,0,0,0,0,0,0,0,1
1,0|1,0|1,0,0,1,s,0,0,0,0,1,L,1,1,1,0,0,1,0|1,0|1,0|1,0|1,0|1,1
1,1|1,1|1,0,0,1,1,1,1,0,0,0,L,0,0,0,0,0,1,0|1,0|1,0|1,0|1,0|1,1
1,0,0,0,0,0,0,0,1,s,s,s,L,0,0,0,0,0,1,1,1,1,1,0|1,1
1,1,1,1,1,1,1,1,1,1,1,1,1,1,1,1,1,1,1,1,1,1,1,1,1