1,1,1,1,1,1,1,1,1,1,1,1,1,1,1,1,1,1,1,1,1,1,1,1,1
1,0,0,0,0,0,SF,0,0,0,0,0,0,0,0,0,0,0,0,0,0,0,0,0,1
1,0,0,0,0,0,0,0,0,0,0,0,0,0,0,0,0,0,0,0,0,0,0,0,1
1,0,0,0,0,0,0,0,0,0,0,0,0,1,1,1|0,0|0,0|0,1|0,0|1,0|1,0,0,0,1
1,1,1,0,0,0,0,0|0,0|0,0|0,0|0,0,0,0,0,0|1,0|1,0|1,1|1,0|1,0|1,0|1,0|1,0|1,1
1,0,0,P,0,d,0|0,0|0,1|0,0|0,0|0,0|0,0|0,0,0,0|1,0|1,1|1,1|1,1|1,1|1,1|1,1|1,0|1,1
1,1,1,1,1,1,1,1,1,1|0,1|0,1|0,1|0,1,1,1,1,1,1,1,1,1,1,1,1